"filename", "language", "JavaScript", "CSS", "SCSS", "XML", "comment", "blank", "total"
"c:\Users\Adaxiom\Desktop\New folder testing\sdc-front\src\App.css", "CSS", 0, 33, 0, 0, 0, 6, 39
"c:\Users\Adaxiom\Desktop\New folder testing\sdc-front\src\App.js", "JavaScript", 40, 0, 0, 0, 0, 4, 44
"c:\Users\Adaxiom\Desktop\New folder testing\sdc-front\src\App.test.js", "JavaScript", 7, 0, 0, 0, 0, 2, 9
"c:\Users\Adaxiom\Desktop\New folder testing\sdc-front\src\App___old.js", "JavaScript", 37, 0, 0, 0, 0, 4, 41
"c:\Users\Adaxiom\Desktop\New folder testing\sdc-front\src\components\ButtonRiot\index.jsx", "JavaScript", 26, 0, 0, 0, 0, 3, 29
"c:\Users\Adaxiom\Desktop\New folder testing\sdc-front\src\components\Button\index.jsx", "JavaScript", 23, 0, 0, 0, 0, 4, 27
"c:\Users\Adaxiom\Desktop\New folder testing\sdc-front\src\components\Footer\index.jsx", "JavaScript", 118, 0, 0, 0, 0, 7, 125
"c:\Users\Adaxiom\Desktop\New folder testing\sdc-front\src\components\LogoDiscord\Logo.css", "CSS", 0, 4, 0, 0, 0, 0, 4
"c:\Users\Adaxiom\Desktop\New folder testing\sdc-front\src\components\LogoDiscord\index.jsx", "JavaScript", 19, 0, 0, 0, 0, 4, 23
"c:\Users\Adaxiom\Desktop\New folder testing\sdc-front\src\components\LogoSuites\LogoSuites.css", "CSS", 0, 42, 0, 0, 0, 6, 48
"c:\Users\Adaxiom\Desktop\New folder testing\sdc-front\src\components\LogoSuites\indexc1.jsx", "JavaScript", 15, 0, 0, 0, 0, 2, 17
"c:\Users\Adaxiom\Desktop\New folder testing\sdc-front\src\components\LogoSuites\indexd1.jsx", "JavaScript", 15, 0, 0, 0, 0, 2, 17
"c:\Users\Adaxiom\Desktop\New folder testing\sdc-front\src\components\LogoSuites\indexh1.jsx", "JavaScript", 15, 0, 0, 0, 0, 2, 17
"c:\Users\Adaxiom\Desktop\New folder testing\sdc-front\src\components\LogoSuites\indexs1.jsx", "JavaScript", 15, 0, 0, 0, 0, 2, 17
"c:\Users\Adaxiom\Desktop\New folder testing\sdc-front\src\components\Logo\Logo.css", "CSS", 0, 4, 0, 0, 0, 0, 4
"c:\Users\Adaxiom\Desktop\New folder testing\sdc-front\src\components\Logo\index.jsx", "JavaScript", 20, 0, 0, 0, 0, 2, 22
"c:\Users\Adaxiom\Desktop\New folder testing\sdc-front\src\components\Navbar\NavbarStyles.js", "JavaScript", 158, 0, 0, 0, 2, 17, 177
"c:\Users\Adaxiom\Desktop\New folder testing\sdc-front\src\components\Navbar\index.jsx", "JavaScript", 103, 0, 0, 0, 1, 13, 117
"c:\Users\Adaxiom\Desktop\New folder testing\sdc-front\src\components\Navbar\navbar.css", "CSS", 0, 12, 0, 0, 0, 1, 13
"c:\Users\Adaxiom\Desktop\New folder testing\sdc-front\src\components\Navbar_old\NavbarStyles.js", "JavaScript", 141, 0, 0, 0, 2, 16, 159
"c:\Users\Adaxiom\Desktop\New folder testing\sdc-front\src\components\Navbar_old\index.jsx", "JavaScript", 90, 0, 0, 0, 1, 9, 100
"c:\Users\Adaxiom\Desktop\New folder testing\sdc-front\src\components\Navbar_old\navbar.css", "CSS", 0, 12, 0, 0, 0, 1, 13
"c:\Users\Adaxiom\Desktop\New folder testing\sdc-front\src\components\ScrollIntoView\ScrollIntoView.js", "JavaScript", 10, 0, 0, 0, 0, 4, 14
"c:\Users\Adaxiom\Desktop\New folder testing\sdc-front\src\components\championCard\championCard.js", "JavaScript", 108, 0, 0, 0, 9, 4, 121
"c:\Users\Adaxiom\Desktop\New folder testing\sdc-front\src\components\championCard\style.css", "CSS", 0, 146, 0, 0, 14, 18, 178
"c:\Users\Adaxiom\Desktop\New folder testing\sdc-front\src\components\profileComponents\avgKdaCanvas.jsx", "JavaScript", 67, 0, 0, 0, 46, 3, 116
"c:\Users\Adaxiom\Desktop\New folder testing\sdc-front\src\components\profileComponents\kdCanvas.jsx", "JavaScript", 72, 0, 0, 0, 64, 6, 142
"c:\Users\Adaxiom\Desktop\New folder testing\sdc-front\src\components\profileComponents\killCard.jsx", "JavaScript", 45, 0, 0, 0, 2, 2, 49
"c:\Users\Adaxiom\Desktop\New folder testing\sdc-front\src\components\profileComponents\scoreCard.jsx", "JavaScript", 53, 0, 0, 0, 4, 2, 59
"c:\Users\Adaxiom\Desktop\New folder testing\sdc-front\src\components\profileComponents\style.css", "CSS", 0, 161, 0, 0, 39, 19, 219
"c:\Users\Adaxiom\Desktop\New folder testing\sdc-front\src\index.css", "CSS", 0, 13, 0, 0, 0, 2, 15
"c:\Users\Adaxiom\Desktop\New folder testing\sdc-front\src\index.js", "JavaScript", 14, 0, 0, 0, 5, 6, 25
"c:\Users\Adaxiom\Desktop\New folder testing\sdc-front\src\index___.js", "JavaScript", 12, 0, 0, 0, 3, 3, 18
"c:\Users\Adaxiom\Desktop\New folder testing\sdc-front\src\logo.svg", "XML", 0, 0, 0, 1, 0, 0, 1
"c:\Users\Adaxiom\Desktop\New folder testing\sdc-front\src\pageStyles\aboutus.js", "JavaScript", 0, 0, 0, 0, 0, 1, 1
"c:\Users\Adaxiom\Desktop\New folder testing\sdc-front\src\pageStyles\bootstrap.min.css", "CSS", 0, 0, 0, 0, 0, 1, 1
"c:\Users\Adaxiom\Desktop\New folder testing\sdc-front\src\pageStyles\game.css", "CSS", 0, 20, 0, 0, 0, 3, 23
"c:\Users\Adaxiom\Desktop\New folder testing\sdc-front\src\pageStyles\game.js", "JavaScript", 133, 0, 0, 0, 11, 18, 162
"c:\Users\Adaxiom\Desktop\New folder testing\sdc-front\src\pageStyles\homepage.js", "JavaScript", 213, 0, 0, 0, 18, 31, 262
"c:\Users\Adaxiom\Desktop\New folder testing\sdc-front\src\pageStyles\homepageTest.js", "JavaScript", 184, 0, 0, 0, 18, 24, 226
"c:\Users\Adaxiom\Desktop\New folder testing\sdc-front\src\pageStyles\homestyle.scss", "SCSS", 0, 0, 152, 0, 2, 24, 178
"c:\Users\Adaxiom\Desktop\New folder testing\sdc-front\src\pageStyles\live.css", "CSS", 0, 49, 0, 0, 0, 9, 58
"c:\Users\Adaxiom\Desktop\New folder testing\sdc-front\src\pageStyles\live.js", "JavaScript", 19, 0, 0, 0, 0, 4, 23
"c:\Users\Adaxiom\Desktop\New folder testing\sdc-front\src\pageStyles\match.css", "CSS", 0, 20, 0, 0, 0, 3, 23
"c:\Users\Adaxiom\Desktop\New folder testing\sdc-front\src\pageStyles\match.js", "JavaScript", 142, 0, 0, 0, 2, 17, 161
"c:\Users\Adaxiom\Desktop\New folder testing\sdc-front\src\pageStyles\profile.css", "CSS", 0, 33, 0, 0, 5, 1, 39
"c:\Users\Adaxiom\Desktop\New folder testing\sdc-front\src\pageStyles\profile.js", "JavaScript", 103, 0, 0, 0, 1, 12, 116
"c:\Users\Adaxiom\Desktop\New folder testing\sdc-front\src\pageStyles\schedule.css", "CSS", 0, 20, 0, 0, 0, 3, 23
"c:\Users\Adaxiom\Desktop\New folder testing\sdc-front\src\pageStyles\schedule.js", "JavaScript", 135, 0, 0, 0, 11, 17, 163
"c:\Users\Adaxiom\Desktop\New folder testing\sdc-front\src\pageStyles\standings.css", "CSS", 0, 79, 0, 0, 38, 14, 131
"c:\Users\Adaxiom\Desktop\New folder testing\sdc-front\src\pageStyles\standings.js", "JavaScript", 103, 0, 0, 0, 1, 10, 114
"c:\Users\Adaxiom\Desktop\New folder testing\sdc-front\src\pageStyles\standingsDraft.js", "JavaScript", 51, 0, 0, 0, 0, 5, 56
"c:\Users\Adaxiom\Desktop\New folder testing\sdc-front\src\pageStyles\statistics.css", "CSS", 0, 25, 0, 0, 0, 4, 29
"c:\Users\Adaxiom\Desktop\New folder testing\sdc-front\src\pageStyles\statistics.js", "JavaScript", 126, 0, 0, 0, 0, 14, 140
"c:\Users\Adaxiom\Desktop\New folder testing\sdc-front\src\pageStyles\statisticsCustom.css", "CSS", 0, 24, 0, 0, 7, 5, 36
"c:\Users\Adaxiom\Desktop\New folder testing\sdc-front\src\pageStyles\teams.css", "CSS", 0, 17, 0, 0, 0, 2, 19
"c:\Users\Adaxiom\Desktop\New folder testing\sdc-front\src\pageStyles\teams.js", "JavaScript", 102, 0, 0, 0, 1, 12, 115
"c:\Users\Adaxiom\Desktop\New folder testing\sdc-front\src\page\aboutus.jsx", "JavaScript", 12, 0, 0, 0, 0, 2, 14
"c:\Users\Adaxiom\Desktop\New folder testing\sdc-front\src\page\allStatistics.jsx", "JavaScript", 464, 0, 0, 0, 4, 22, 490
"c:\Users\Adaxiom\Desktop\New folder testing\sdc-front\src\page\game.jsx", "JavaScript", 11, 0, 0, 0, 0, 4, 15
"c:\Users\Adaxiom\Desktop\New folder testing\sdc-front\src\page\homepage.jsx", "JavaScript", 171, 0, 0, 0, 0, 6, 177
"c:\Users\Adaxiom\Desktop\New folder testing\sdc-front\src\page\live.jsx", "JavaScript", 30, 0, 0, 0, 23, 6, 59
"c:\Users\Adaxiom\Desktop\New folder testing\sdc-front\src\page\match.jsx", "JavaScript", 110, 0, 0, 0, 3, 10, 123
"c:\Users\Adaxiom\Desktop\New folder testing\sdc-front\src\page\profile.jsx", "JavaScript", 181, 0, 0, 0, 22, 19, 222
"c:\Users\Adaxiom\Desktop\New folder testing\sdc-front\src\page\profileTry.jsx", "JavaScript", 235, 0, 0, 0, 19, 22, 276
"c:\Users\Adaxiom\Desktop\New folder testing\sdc-front\src\page\schedule.jsx", "JavaScript", 147, 0, 0, 0, 5, 9, 161
"c:\Users\Adaxiom\Desktop\New folder testing\sdc-front\src\page\standings.jsx", "JavaScript", 126, 0, 0, 0, 2, 7, 135
"c:\Users\Adaxiom\Desktop\New folder testing\sdc-front\src\page\standingsDraft.jsx", "JavaScript", 24, 0, 0, 0, 14, 6, 44
"c:\Users\Adaxiom\Desktop\New folder testing\sdc-front\src\page\statistics copy Old.jsx", "JavaScript", 427, 0, 0, 0, 4, 21, 452
"c:\Users\Adaxiom\Desktop\New folder testing\sdc-front\src\page\statistics.jsx", "JavaScript", 432, 0, 0, 0, 4, 22, 458
"c:\Users\Adaxiom\Desktop\New folder testing\sdc-front\src\page\teams.jsx", "JavaScript", 219, 0, 0, 0, 0, 5, 224
"c:\Users\Adaxiom\Desktop\New folder testing\sdc-front\src\reportWebVitals.js", "JavaScript", 12, 0, 0, 0, 0, 2, 14
"c:\Users\Adaxiom\Desktop\New folder testing\sdc-front\src\setupTests.js", "JavaScript", 1, 0, 0, 0, 4, 1, 6
"c:\Users\Adaxiom\Desktop\New folder testing\sdc-front\src\themes.js", "JavaScript", 8, 0, 0, 0, 0, 0, 8
"Total", "-", 5144, 714, 152, 1, 411, 574, 6996